ID=A
EAN=B
CodigoInterno=C
CodigoIMendes=D
Status=E
Descricao=F
NCM=G
CEST=H
PercIPI=I
CSTIPI=J
CSTPisCofinsEnt=K
CSTPisCofinsSai=L
NatRecIsentaPisCofins=M
Lista=N
Tipo=O
PercPIS=P
PercCOFINS=Q
CFOPCompra=R
CFOPVenda=S
CST=T
CSOSN=U
ModBC=V
PercICMS=W
PercICMSPDV=X
SimbPDV=Y
PercRedBCICMS=Z
PercRedBCICMSST=AA
ModBCST=AB
PercICMSST=AC
IVA=AD
PautaST=AE
PercFCP=AF
Antecipado=AG
PercDesoneracao=AH
PercDiferimento=AI
PercIsencao=AJ
aDRemICMS=AK
CodANP=AL
CodBeneficio=AM
DataAlteracao=AN
DataRevisao=AO
DataUltimoConsumo=AP
CodigoGPC=AQ